NO 220,100,0,32
SO 220,100,0,32
WE 220,100,0,32
EA 220,100,0,32
F ./texture/cool.xpm42
C ./texture/cool.xpm42
111111
100001
110011
 101
 111