NO ./texture/mc/grass_side.xpm
SO ./texture/mc/stone.xpm
WE ./texture/mc/grass_top.xpm
EA ./texture/mc/stone.xpm
C 128,128,128
F 25,25,25
111111
100101
101001
1100N1
111111