NO ./texture/mc/grass_side.xpm
SO ./texture/mc/grass_side.xpm
WE ./texture/mc/grass_side.xpm
EA ./texture/mc/grass_side.xpm
C 128,128,128,0
F 25,25,25,0
                        111111
                        1000001
                       100111001
                      1001   1001
                     1001     1001
                    1001       1001
                   1001         1001
                  1001           1001
                 1001             1001
                1001               1001
              11001                 1001111111111111
             10001                   100000000000001
   11111111110011                     11111111111001
   100000011001                                1001
   1000000000111                              1001
   10000001111                               1001
   10000001                                 1001
   10000001                                1001
   10000001                               1001
   10000001                              1001
   10000001                             1001
   10000001                            1001
   10000001                           1001
   10000001                          1001
   10000001                         1001
   10000001                        1001
   10000001                       1001
   10000001                      1001
   10000001                     1001
   10000001111111111111111111111001
   10000000000000000000000000000001
   10000001111111111111111111111111
   10000001
111100000011111111111111111111
100000000000000000000000000001
111100000011111111111111111111
   10000001
   10000001
111100000011111111111111111111
100000000000000000000000000001
111100000011111111111111111111
   11110001
   10000111
   10000001
   11110001
   10000111
111100000011111111111111111111
100000000000000000000000000001
111100000011111111110000011111
   10000001        1000001
   11111111        1000001
                   1000001
                   1000001
                   1000001
                   1000001
                   100N001
                   1111111
