NO ./texture/teapot.xpm
SO ./texture/teapot.xpm
WE ./texture/teapot.xpm
EA ./texture/teapot.xpm
F ./texture/teapot.xpm
C ./texture/teapot.xpm
111 111
1011101
1E00001
1111111
