NO ./texture/teapot.xpm
SO ./texture/teapot.xpm
WE ./texture/teapot.xpm
EA ./texture/teapot.xpm
F ./texture/teapot.xpm
C ./texture/teapot.xpm
111111111
100W001111
111111111