NO ./texture/mc/grass_side.xpm
SO ./texture/mc/grass_side.xpm
WE ./texture/mc/grass_side.xpm
EA ./texture/mc/grass_side.xpm
F ./texture/mc/grass_top.xpm
C ./texture/mc/stone.xpm
111111111111111111111
100000000000000000001
101110111010111011101
101000100010001000101
101000000010000000101
100001111010111100001
101101000000001101101
101001000000000100101
101001000000000100101
100000000000000000001
1011110000N0000111101
100000000000000000001
101001000000000100101
101001000000000100101
101101100000000101101
100001111010111100001
101000000010000000101
101000100010001000101
101110111010111011101
100000000000000000001
111111111111111111111